16x42
000000000000000000000000000000000000000000
000000000000000000000000000000000000000000
000000000000000000000000000000000000000000
000000000000000000000000000000000000000000
000000000000000000000000000000000000000000
000000000000000000000000000000000000000000
000000000000000000000000000000000110000000
000000000000000000001100000000001110001111
000000000000000000111000000000011110000011
000010000010000001100000000000111111000001
000011000110000111000010000000111111100011
100111100100001110000110000011111110000111
101111000101111110000111000011111110001111
111111111111111111111111111111111110011111
111111111111111111111111111111111110111111
111111111111111111111111111111111111111111