15x42
000000000000000000000000000000000000000000
000000000000000000000000000000000000000000
000000000000000000000000000000000000000000
000000000000000000000000000000000000000000
000000000000000000000000000000000000000000
000000000000000000000000000000000000000000
000000000000000000000000000000000000000000
000000000000000000000000000000000000000000
111111111111111111111111111111111111111111
000000000000000000000000000000000000000000
000000000000000000000000000000000000000000
101111000101111110000111000011111110001110
111111111111111111111111111111111110011111
111111111111111111111111111111111110111111
111111111111111111111111111111111111111111